Student ID,Student Name,Subject 1,Subject 2,Subject 3,Subject 4,Subject 5,Total Marks,Grade
1,om,50,80,70,60,65,325,B
2,sai,40,80,70,60,65,315,B
3,ram,56,45,54,65,55,275,C
4,radha,40,76,65,67,76,324,B
5,krishna,54,45,76,67,65,307,B
6,jiya,76,80,70,60,57,343,B
7,piya,56,76,80,76,54,342,B
8,siya,45,54,64,65,60,288,C
9,piyu,56,76,67,80,54,333,B
10,jeni,65,67,65,89,54,340,B
